06,02,02,02,02,02,02,02,02,03
01,00,00,00,00,00,00,00,00,01
01,00,00,00,00,00,00,00,00,01
01,00,00,00,00,00,00,00,00,01
01,00,00,00,00,00,00,00,00,01
01,00,00,00,00,00,00,00,00,01
01,00,00,00,00,00,00,00,00,01
01,00,00,00,00,00,00,00,00,01
01,00,00,00,00,00,00,00,00,01
05,02,02,02,02,02,02,02,02,04

1,1,1,1,1,1,1,1,1,1
1,0,0,0,0,0,0,0,0,1
1,0,0,0,0,0,0,0,0,1
1,0,0,0,0,0,0,0,0,1
1,0,0,0,0,0,0,0,0,1
1,0,0,0,0,0,0,0,0,1
1,0,0,0,0,0,0,0,0,1
1,0,0,0,0,0,0,0,0,1
1,0,0,0,0,0,0,0,0,1
1,1,1,1,1,1,1,1,1,1